xxxxxxxxxxxxxxxxxxxxxxxxxxxxxxxxxxxxxxxxxxxxxxxxxxxxxxxxxxxx
x##########################################################x
x0000000000000000000000000000000000000000000000000000000000x
x0000000000000000000000000000000000000000000000000000000000x
x0000000000000000000000000000000000000000000000000000000000x
x0000000000000000000000000000000000000000000000000000000000x
x0000000000000000000000000000000000000000000000000000000000x
x0000000000000000000000000000000000000000000000000000000000x
x0000000000000000000000000000000000000000000000000000000000x
x0000000000000000000000000000000000000000000000000000000000x
x0000000000000000000000000000000000000000000000000000000000x
x##########################################################x
xrrrrrrrrrrrrrrrrrrrrrrrrrrrrrrrrrrrrrrrrrrrrrrrrrrrrrrrrrrx
x----------------------------------------------------------x
xrrrrrrrrrrrrrrrrrrrrrrrrrrrrrrrrrrrrrrrrrrrrrrrrrrrrrrrrrrx
xrrrrrrrrrrrrrrrrrrrrrrrrrrrrrrrrrrrrrrrrrrrrrrrrrrrrrrrrrrx
xrrrrrrrrrrrrrrrrrrrrrrrrrrrrrrrrrrrrrrrrrrrrrrrrrrrrrrrrrrx
x--   --   --   --   --   --   --   --   --   --   --   -- x
xrrrrrrrrrrrrrrrrrrrrrrrrrrrrrrrrrrrrrrrrrrrrrrrrrrrrrrrrrrx
xrrrrrrrrrrrrrrrrrrrrrrrrrrrrrrrrrrrrrrrrrrrrrrrrrrrrrrrrrrx
xrrrrrrrrrrrrrrrrrrrrrrrrrrrrrrrrrrrrrrrrrrrrrrrrrrrrrrrrrrx
x----------------------------------------------------------x
xrrrrrrrrrrrrrrrrrrrrrrrrrrrrrrrrrrrrrrrrrrrrrrrrrrrrrrrrrrx
xrrrrrrrrrrrrrrrrrrrrrrrrrrrrrrrrrrrrrrrrrrrrrrrrrrrrrrrrrrx
xrrrrrrrrrrrrrrrrrrrrrrrrrrrrrrrrrrrrrrrrrrrrrrrrrrrrrrrrrrx
x--   --   --   --   --   --   --   --   --   --   --   -- x
xrrrrrrrrrrrrrrrrrrrrrrrrrrrrrrrrrrrrrrrrrrrrrrrrrrrrrrrrrrx
xrrrrrrrrrrrrrrrrrrrrrrrrrrrrrrrrrrrrrrrrrrrrrrrrrrrrrrrrrrx
xrrrrrrrrrrrrrrrrrrrrrrrrrrrrrrrrrrrrrrrrrrrrrrrrrrrrrrrrrrx
x----------------------------------------------------------x
xrrrrrrrrrrrrrrrrrrrrrbrrrrrrrrrrrrrrrrrrrrrrrrrrrrrrrrrrrrx
x##########################################################x
xxxxxxxxxxxxxxxxxxxxxxxxxxxxxxxxxxxxxxxxxxxxxxxxxxxxxxxxxxxx
